+++++++++++++++++++++++++++++++++
+0                              +
+A +++++++++++++++              +
+a +             +              +
+  +                            +
+  +                            +
+  +                            +
+  +                            +
+  +                            +
+  +                            +
+  +                            +
+++++++++++++++++++++++++++++++++
