++++++++++++
+0   AAA   +
+    AAA   +
+    AAA   +
+    AAA  a+
++++++++++++
