++++++++++++++++++++
+                  +
+A ++++++++++++++  +
+a +            +  +
++++            ++++
